XXXXXXXXXXXXXXXXXXX
X..2...2...2...2..X
X.XXXXX.X2X.XXXXX.X
X2...2..X.X..2...2X
X.XXX.XXX.XXX.XXX.X
X.X.X..2...2..X.X.X
X.XXX.XXXXXXX.XXX.X
X2..2.........2..2X
XXX.XXXXX2XXXXX.XXX
X...2.........2...X
X.XXXXXXX.XXXXXXX.X
X..2....X.X....2..X
X.XXXXX.X.X.XXXXX.X
X.....X..2..X.....X
X2X.X2.2X.X2.2X.X2X
X2X.XXXXX.XXXXX.X2X
X......1111.......X
XXXXXXXXXXXXXXXXXXX