XXXXXXXXXXXXXXXXXXX
X........X........X
XPXX.XXX.X.XXX.XXPX
X.................X
X.XX.X.XXXXX.X.XX.X
X....X...X...X....X
XXXX.XXX.X.XXX.XXXX
...X.X.......X.X...
...X.X.XX.XX.X.X...
...X...X...X...X...
...X.X.XX.XX.X.X...
...X.X...1...X.X...
XXXX.X.XXXXX.X.XXXX
X........X........X
X.XX.XXX.X.XXX.XX.X
XP.X...........X.PX
XX.X.X.XXXXX.X.X.XX
X....X...X...X....X
X.XXXXXX.X.XXXXXX.X
X.................X
XXXXXXXXXXXXXXXXXXX