XXXXXXXXXXXXXXXXXXXXXXXXXXXXXXXXXX
X................................X
X................................X
X................................X
X................2...............X
X................................X
X................................X
X..............1111..............X
X................................X
X................................X
X................................X
X................................X
X................................X
XXXXXXXXXXXXXXXXXXXXXXXXXXXXXXXXXX